   ###############
   #             #
   # ########### #
   # #         # #
#### #         # #
#@   #    ^      #
#### #         # #
   # #         # #
   # ########### #
   #             #
   ###############