██████╗        ██████╗ ██╗   ██╗███╗   ██╗ ██████╗ ███████╗ ██████╗ ███╗   ██╗    ███╗   ███╗ ██████╗ ██████╗ ███████╗
╚════██╗       ██╔══██╗██║   ██║████╗  ██║██╔════╝ ██╔════╝██╔═══██╗████╗  ██║    ████╗ ████║██╔═══██╗██╔══██╗██╔════╝
 █████╔╝       ██║  ██║██║   ██║██╔██╗ ██║██║  ███╗█████╗  ██║   ██║██╔██╗ ██║    ██╔████╔██║██║   ██║██║  ██║█████╗  
██╔═══╝        ██║  ██║██║   ██║██║╚██╗██║██║   ██║██╔══╝  ██║   ██║██║╚██╗██║    ██║╚██╔╝██║██║   ██║██║  ██║██╔══╝  
███████╗██╗    ██████╔╝╚██████╔╝██║ ╚████║╚██████╔╝███████╗╚██████╔╝██║ ╚████║    ██║ ╚═╝ ██║╚██████╔╝██████╔╝███████╗
╚══════╝╚═╝    ╚═════╝  ╚═════╝ ╚═╝  ╚═══╝ ╚═════╝ ╚══════╝ ╚═════╝ ╚═╝  ╚═══╝    ╚═╝     ╚═╝ ╚═════╝ ╚═════╝ ╚══════╝